{
  "rows": 10,
  "columns": 10,
  "tileset": "plains_atlas",
  "layers": [
    {
      "name": "background",
      "data": [
        [9, 9, 9, 9, 9, 9, 9, 9, 9, 9],
        [9, 5, 6, 6, 6, 6, 7, 9, 9, 9],
        [9, 13, 14, 14, 23, 9, 9, 9, 9, 9],
        [9, 13, 14, 0, 9, 9, 9, 9, 9, 9],
        [9, 13, 23, 9, 9, 9, 9, 9, 9, 9],
        [9, 13, 7, 9, 9, 9, 9, 9, 9, 9],
        [9, 21, 22, 22, 9, 9, 9, 9, 9, 9],
        [9, 9, 9, 9, 9, 9, 9, 9, 9, 9],
        [9, 9, 9, 9, 9, 9, 9, 9, 9, 9],
        [9, 9, 9, 9, 9, 9, 9, 9, 9, 9]
      ]
    },
    {
      "name": "walls",
      "data": [
        [-1, -1, -1, -1, -1, -1, -1, -1, -1, -1],
        [-1, -1, -1, -1, -1, -1, -1, -1, -1, -1],
        [-1, -1, -1, -1, -1, -1, -1, -1, -1, -1],
        [-1, -1, -1, -1, -1, -1, -1, -1, -1, -1],
        [-1, -1, -1, -1, -1, -1, -1, -1, -1, -1],
        [-1, -1, -1, -1, -1, -1, -1, -1, -1, -1],
        [-1, -1, -1, -1, -1, -1, -1, -1, -1, -1],
        [-1, -1, -1, -1, -1, -1, -1, -1, -1, -1],
        [-1, -1, -1, -1, -1, -1, -1, -1, -1, -1],
        [-1, -1, -1, -1, -1, -1, -1, -1, -1, -1]
      ],
      "collision": true
    },
    {
      "name": "objects",
      "data": [
        [-1, -1, -1, -1, -1, -1, -1, -1, -1, -1],
        [-1, -1, -1, -1, -1, -1, -1, -1, -1, -1],
        [-1, -1, -1, -1, -1, -1, -1, -1, -1, -1],
        [-1, -1, -1, -1, -1, -1, -1, -1, -1, -1],
        [-1, -1, -1, -1, -1, -1, -1, -1, -1, -1],
        [-1, -1, -1, -1, -1, -1, -1, -1, -1, -1],
        [-1, -1, -1, -1, -1, -1, -1, -1, -1, -1],
        [-1, -1, -1, -1, -1, -1, -1, -1, -1, -1],
        [-1, -1, -1, -1, -1, -1, -1, -1, -1, -1],
        [-1, -1, -1, -1, -1, -1, -1, -1, -1, -1]
      ]
    }
  ]
}
